NO ./img/wall_n.xpm
SO ./img/wall_s.xpm
EA ./img/wall_e.xpm
WE ./img/wall_w.xpm

F 64,32,0
C 192,224,255

     111     11111111
    10001   1000000001
   1000011 100011110001
  100010001 111 110001
 10001100011  1100011
1000000000001100011
 111111000111000111111
      10001100000000001
      100000000N0000001
      1011111110111111
     1101    11011111
    10001   1000000001
   1000011 100011110001
  100010001 111 110001
 10001100011  1100011
1000000000001100011
 111111000111000111111
      10001100000000001
       111  1111111111
