NO ./img/wall_n.xpm
SO ./img/wall_s.xpm
WE ./img/wall_w.xpm
EA ./img/wall_e.xpm
F 220,100,0
C 225,30,0
111111111111111111111111
1S0000000000000000000011
101111101110101110100001
100000000000100000101001
101110101110111110011001
100000001010001000101001
101111011010111110101101
101000001000000000000001
110110111001101011111011
100000100000000010000001
100110101100111111111011
100000000000000010000011
101110001011101101101111
100010000000000000000001
110010101111011001001111
101010000000100000101001
101110101010101100011011
100000000010001000101001
101010101110110011101001
101000000010001000101001
101110101010111110001001
100000000010100010000001
101011001010011010101101
100000000000001000100001
101100101110111010100011
100000000010100000001011
101110100101111010100001
100000000000000000000001
101110001011101110101011
101000101000101000001001
100011001010101010101101
100000100010100010001011
101001011110111010100011
100000000000001000000001
101010111010111110101001
111111111111111111111111
