NO ./img/wall_n.xpm
SO ./img/wall_s.xpm
WE ./img/wall_w.xpm
EA ./img/wall_e.xpm
F 220,100,0
C 225,30,0
111111111111111111111111111111111111111111111111111111111111111111111111111111111111111111111111111111111111111111111111
1N0000000010000000000000000000000010000000000000000000000000000000001000000000000010000000000010000000000000000000000001
101010100011101010111010101111101011101110101001101111011000011110100011001000100010111010111010101011111011101110111011
100000000000100010000000001000001010000010100010001000001010000010101000100000100000101010000000000000000000000000100011
110110101111100110011111100110111001111010100011100010011110100010101001100111111110101010001110111010010010100101000011
101000000000001000001000001010000000001010001000000000000000001000000000101010001000000000100000001000000000001010001011
101010111000101100001010101010000110100110011110101110101010101110111010111011101000111011101010111010101010111010001011
100010100010100010001010000000100000101000000000000010001000000000001010000010000000001010000010000000001010100000000011
101110111011100111101010001110111111100010001010100011101000101010001011111110001011111000101010011111100010101001101011
100010001000000010101000001010000000000010000000000000100010000000000000100010001000100000001000000010001010001000101011
101110010110111000110000011011001101111011111010011010101111111011110010101011111110111011111011000110100110011111111011
101010000000000000001010100000001000100000101010000000000000000000001000101000000010101010000000000000100000101010100001
101010111010111010101001001010111011001010101010101011100100101111111011101011001000101011111111101010011001100010101011
100000101010100000100000001000001000101010001000000010000000000000001000100000001000100000000000000000101000101000100001
101111101110011001101010111000101010101110111000001011001011101010011010101110101010101010011010101111101111100011101011
100000000000100000000010000010001000100000000010000000000000100010001010000010000000000000100010100000000010000000000001
111011111001101110111011111100111100101111011011101001101001111110001001110000101010111011100011100010001010101010101011
101000000000000010000000100000001000100000101010000000001000000010001000000000001000000000101000100000000010001000000001
101000001111001011001110001010111111001010101010101111101001011110101011001010111111000110000011011110101000101011011111
100000001000100000101010100000100000101010001000101000000010100010101010000010101000000010000010000000000010100000000001
101000011011100110101010101011001010101010011111101010011000011111100010101111100011111111111101101110000010000010101111
101000001000000010100000000010001010100010100000100000000010101000100010101000001010001010100010101000000010000000101001
111011101011111110101010010011010000101110101100101100011010000011010011100010111011011010001010101010101001101001101011
100000100000000010100010000010000000101010000010001000100000000000000010001000101010001000000000001000100010100010100001
101010110000001010101110001011101110101011100001001010101010011011100100011000101010011010101110100010111000101010100001
100000000000000000000000101000000000000000000000100000001010100000100000000010100000000010101000101010100010100000001001
101011110010110010110110100011101010001011111100101110101110001111101010101010111011111010101010101010101010001010000111
100000000000100010000010100000100000001010000000101000100000001000001000001010001000001000000010100010000000000010100011
101111100010111110111000101010100010110010100010101111100110101011100110001010111010111010101011100110100010101111111101
100010100010000010101000000000000000001010000000100000000000001010000010100010100010000000001010000000000000101000100001
100010101011110010001111100011101001101110110111101100111000100010111010011011101101100111101100001011101110101110101011
100000101010001000100000000000001010100000001000000010000000001000001000001010100000001000001010000010100010001000100001
111010101010101110110011100110100010100110101010101011001110101010100110101010100011011011101010100000100010011001111011
100000000000100000000000000010100000001010101000100010000000000000100000101010000000100000100010000000000000001000000001
101010101010101110101111100101101010101010101011101010101010101110100110101010111010111110101011101100101010101110100001
100010101000000000000000000000101000001010000010000000100010000000000000001000000000000010000010000000000000000000000011
100110101010101111101110101010001010101011101111001110011011100001011010100010001011111001111011001101100010001011111111
101000000000100000000010000000101010000000001000000010000000001000100000100000000000001000001000000010001010001000000001
101011101010101000100001000010101011101010111101101110101110101010101001101110101110111000111110100110100100001110101101
100000101000100000000000000000001010100010000010000000000010000010000000000010100000100000000000001010100000000000001001
101010001000011010001110101010111000111011101011011011101000101010101010101111110000100110101011101010111111000101000111
100010101000100000001010001000101000100000101000000000100000001010101010000000001010000010100000100010001010000000001001
101011111101101010101010101111100010101100101100101011100000011000101111111000001111101010110001101111111010111010010011
101000000010100000100000000010000000000010001000000010000000100010100000100000101010001000000000101010000000001000000001
111110101010111011101000111010100110101001001010101000001010111110001100100011101011101011101110001010001011001111111111
100000001000001010001010100000001000001000100000001000000010000000001000000000100000000000100000000010100000000000001001
101011101110111010001011100101101111111000101000101110111011101010101010111110111000101000110110101010111010110100001011
101010000000001010101000000000000000100010100000100000000000000000000010001000100000000000100010000010001000000000001001
101110101111101000101010111010111100101011101110101101101010101110111111111110001110101111111010101010101011101111001101
101010000000100000101000001010000000000000000000100000000010100010100000100000101010100010101000100000001000000010101001
110010001011101110011010111001001010101010111100100010100110100001011000011010111000101010100010110010110110101000101011
101000000000000000001000000010000000001010100000101010000010001000000010001000000000000000001000100010000000000000000001
100110111011001010100011101000101001111000101011111100100110111000111111101010101011100010011110100010111110111110101011
100000000000000000000010001000000000000000001000001000100010001000001000000000000000000000001010101010000000100000000001
101110111110101011111011010010101001111010111111110010000110110010001010101010011011101010110011100010010010101010101011
100010101000000000100000001010100010001000100000001000001000000010000010100000000000100000001010000000100000001000100011
100110000001101110101000101011111010101010101111011010101110101111101001101010111000100010101100110010111010101110101111
100010100000000000000000100000100010000010001000100000001000100000100000000000100000101010000000000000001000000000100001
101110111110101010101010101010011011100110101001111010001100001100111110011010001011111011111100011110111010100100001111
101000000010000000000010100000100010000000001000001000000010000010101000000000100000001010000000000000100010100010100011
101100101010101010111111111100111011101001101000111010001110101011101111101011110011100010000110110010101001001100111011
100010000000001000100010000010100000101000101000001000101010000000100000000000001000000000101000000010100000100010000011
101010100010101011100010100010011110111000101010111111001010111111111110101011011010101111001010101010111110101010101011
100000000000000000100010001000001000101000000000000000000000000000001000101010000010100010001010000010000000100000100011
111010001000101010111110011001101110001011100010111110101010101001001110101010101010001110100110101000001010101001101111
101000000010101000000000100000100000000010000000000000100000101000001010001000100010000000100010100010100010001000000011
101010111001101010100111101111101000001111101010100111110011101010111001111111101011101111111000111011111110100010101011
101010001000101010100000000000100010101000101000101000000000000010000000100000001000000000100000001000000000001000001001
101010101011111110010111101010111010101011101011110010111010101110011011101010011011101010101010111111111110111011111011
100000100010000010000010100010001010001010001010100000001000000010000000001010000010001000000010001010101000000000100001
101010111000101011111010010010101110101110111010101110111010101010101010111011100111111110110010100000001000101000101011
101000000000000000001010100010101010000000000000001010000000000000100000000000000000100010101000101000101000100010000011
101011001011101111111010110010101011101010101110101010000000100110001000010100101111101011000011101100111010101010111011
100000001000001000001000100010000000000000000000000000100010001000000010000000001000100000100000000010000010001010000001
101010110010101010101010101110111111101111101100100110001100111100100110101101101010001001110101011111101110011011101111
100000000010000000100010000010100000101000001000000000000000100010000010001000000000000000000000000000101010100010001001
101110110001100000111011111010101110101100111110101000101111101011101010101000111111001001101100101110110011111110100011
101010100010000000001000100000001000000010001000001000001010000010000000000000000000000000101000101000101010000010000011
101011101010101000101010101011111010101011101011101010101011000010110111101000101001100111100000100000101010111011101001
101000000000000000000000001000001010001010100000000000000000000000000010000010101010001000101000001010001000100000100001
100111001010101011001000101000101010111010101011101101101110101101101010101011101011101011101010101011111011100010101001
100000000010000000000000001010000000100000001000000000100000101010000000100010101010100000101010100000000000100010000011
100000011001100010111011101110011000001000101110001011101001101010111110101010111110101110010110001110101010000000101011
100000101000000000101000000000100000000000100010000000100010001000101000000010001000001000000000001000001010001000001011
101010101010101000101100101110101100111010101001001010111010101001101000101011101011111011101010101010111000101011101111
100000000010000000100000100000100000000010001000000000000010101010001000001010100010000000001000000000100000000000000011
101110101010100010111100101010111011101111101011101010011010001110101010101110001011000010101110101101111010111110001011
100010000000100010000000001010001000000000001000001000000010100000101000000010100000100000001000001000001000001000001001
100011110010001001101010100001000110101110111010011010101010101011001010101110111010101010101100101011111010101111111011
101000001000000000000010101000100000000000101000000000101010000010101010100000100010001010101010000000000010001000101001
101010110110101011010010101110101110011010101100110110110010001010000010111110101011101010111011111110101010101010101011
100010000000000000100000001010100010001010001010101000000010100000001000100000101010101000000010001000100000000000100011
101001111011101000001001111010101001111111101010101100101110101010101110101010011010101010100110111011111111101010101111
100000001000000010100010001000000010001000000000100000001000001010100000100000000000000010000010000000001000001000000001
101011100000101010001111011010011110111110100011111110110010101001101000111110101011001111111111101110101011111011111011
101000100000000000100000000000000000100000101000001000100010000000101000100000001000001000001000100010001000001000101001
100110110110011011101111111011101011101000101010101010101101100011101110101000101010101101111110111011111111100110101011
100010000010001000000000101000001000000000000000100000000000000000001000000000000000000000100010000000100010000010000001
101011011100001010001001101010101110100111111010101110100111101000110011101110110000111010101000101010101011101010111011
100000100000100000101000000000000000000010000000000010001010101000100010100000101000000000000000100000001000001010000011
110110011001101000011011000000101101001110100111111101101010100000101110011110001010101010111010101110101011101010101111
100010000000000010000000100000100000000010000000100000100000001010000010001000000000000010001000000010101000001010100011
101010011000101111111011101000111101101011100111111001101011100011111010101111101001101110001010000010101011101100101001
100010000010100000000000000000101000000000100000101000001010100010000000000010001000100000100000000010001000101000000011
110010111111111110111011111010101010111010111010101010100000111101000100111011001110110110101011111110101001110010101011
101010100000100010001000100010000000100000000010001010000000100000001000100000000000101000101010001000001000100000000001
100111101110001000100010101011101010111000101010101000101000111010110100101011001111101001101000101100001100001110011111
100000101010000000000000000010000000000010101000001010000010100000001000001010100000101000000000101000000010000010100001
101000101010100010101011101000011011111010101000101110111011011011101000011010001011100010110010101001111010110000110101
100010000010000000001000101000001000000010100000100000001010101000000000000010000010100000001000001000000010000010000001
101111000011101010101010001110001011001000001110101100101010100000101111111110101110100001111011001011101010100000100011
101000100000001010000000100000100010001010000000100000000010001000100010001000001000101000000000100010101010101000000011
101001101100110010101001111010101010101010111001111011101101101010001010110010101110011010111000011010001000111011011011
100000100010000000100000101010000000100010001000101000100000000000000000000000000000100000000000000000101000000000101011
100011111011101110111110100010111010101111010000101001011111111010100010010011101010101001111110100010001010100111101111
100000100000100000000000000000000000001000100010101000101000000010000000100000100000100000000010001000000010100010001001
111110101010111110111110101011111011010000100001111011101011001010101110100010101010100010000000111000111011011010111011
100000000000000000100000100010000000001000100010000000000000000000000000101000100000100000101010000010101000100000000011
101011101101111011101010100000101010100011101011101010001001111110101010000010001010111001110010100110101111001001011111
100000001000100010000000001000000010000000000010101000001000100010001010100010000010001000100000001000100000100000001001
111110001110101010011111101010110110100110100010110011111001100010111010111110101110101010101100110110101010111000101011
100000000000000000001000000010100000100000000010001000100000000010100010100000100010000010000010000000000010101010001001
101011101100110010101010101110101010101010101011101010001010111110110010101001101011111001110110011111011011101010101111
100000000010100010000000000000100010000000001000001000000000100010100000000000000000001000000010100000001000100000101011
100111101010101011101011111011101010101111100010101010101100001110101011111100101110111010101011111000101010101001101011
100000000000000000001000101010101000100000000010000000000000000000000000100000000010000010000000001000100000000000100011
101010101001011011101010100000101010101011111110100111101010100011001110100110101011100010101011101110001010000010101011
100000001000001000101000101010100010001000000000001000100000101000101000000010000010100000100000101000000010000000000001
101011001011111010101010111001100011101110111010101110111111101000101001000010011010001000101010101000101011101010100011
100000100000000000000010000000100000001000001000001000000010001010000000100000100000000010100000101000100000001000100001
101010111010100100100010101010111010101111101110101010011011000011101011111110111110110010111110101010110000001010100011
100000001010100010001010100000000000000000000000001010100010000010001010000010100000100000100010100000001000000010101001
101101011011100111111000011111000110100011101110001110001110001110111110101110110000101101111011101011101010111010111011
100000101000000010001000000010000010101010001000100000001000101000000010100000000010100000000000101000000000000010100011
101010101100100010111010011010111010001010111111101001111010101011101110101101111110110010101011110111101110001110001011
101000101000000010000010001000000010101010101000000010000000000000100010100010001000001000001000000000000000000000000011
101001101000100010101110101010101110111100101011100010101010101111111110111000100011101100111110100010100010100010111001
100000001000100010000010100000100010100010100000100000001010000000101010001000100010100000100000000000000000001000000011
101110101010011011110110111010011010101011101010000010101010101100101011101110101110101111111110111010111000111100101001
101000000000000000100000001000000000000000000000001010000000000010000000001010001000100010000000000000100010100010000001
100010101010101010101010111010101110111011101011001000111111100010111011111000111011101111111011101110101010101001001011
101000000000100000100010001000000000100000100010100000100000001000000010101010000010001000100000101000001000000010100001
101001101111110010111010101111101010111110110010111010111010111111111010101010001010101010001110101111100010111010101011
101000001010000000100010100000000010100010000000000000000000101000000010000010101000100010001000101010001000000010001001
111010111010101010100011101010100000111110101010001011101010100010110010101011101001111000101010001001011111101110110011
101000001000000010001000000010101000001000000000001000101000001010000010001000000000001000000000101010000010000000000001
101010101110011010111100100110101110101111011010001010101010101011111110111110111000101011101001010011110100101110101011
101010000000000000001010000010100000000000001000101010000010001000100000000000000000001000101000100000001000001000000001
101010101000101010111010111010010110100110111010111010101000111110111010111000001000111010001111101010101010001111110111
101010101010100010001010001010001000000000000010101000001010000000101010001000001010000010001000100000000000100000001001
111011101111001001101011111011101010011010110111100110111010101010001010101111111110001011011010111010101010001010101011
100000001000001000001000101000101000000000100010100010001010001000001000100000000000000000000000100000000000000000100001
101110111101101010110010100101101010101010101010111101101111100110101010101000101010010110001110111000101010100110111111
100010000000100010000000000010000000000000000000000000000000101000001000100000101010100000001000101010101000001000000001
101011100111101001111111100110001001101011110010100111111001101110100010101010111101111100101011101011100010101111101011
100000100010001000100000000000100010000000100000000010100000100000101000000000001000100000001000001000000010100010001001
101010111011001010110011001010111010001100100111101110101011111010011001110011110010001010100110111010101011101011100001
100000001000000000100010000010101010000000001010000000100000000000000010000010000000101000101000100000100010101010000001
110000011000111011111010000110100110101110101010001110101000101010111011011011101010100111101110101011101100001111010111
111111111111111111111111111111111111111111111111111111111111111111111111111111111111111111111111111111111111111111111111
