NO ./img/wall_n.xpm
SO ./img/wall_s.xpm
EA ./img/wall_e.xpm
WE ./img/wall_w.xpm
F 64,32,0
C 192,224,255

1111111
1111111
1110111
110N011
1111011
1111111
1111111