NO ./img/wall_n.xpm
SO ./img/wall_s.xpm
WE ./img/wall_w.xpm
EA ./img/wall_e.xpm
F 220,100,0
C 225,30,0
11111111111111111111111111111111111111111111111111111111111111111111111111111111
1N000000000000000000000000001000000000001000000000000010000000000000000000000001
10101011101000101010100110101010101110101110110010101110101110100010101110001011
10001000000010100000100000101010100000100000001000100000001000100000100010000011
10000010101110101010001100101010101010001100011110101011111011111110100110101011
10000000001000001010001010000000100010100000000000001000000000100000000010101011
10111100101110100110101011101110111100101000111010001010000010101010001110010111
10000010100000101000100000000010000010000000100010001010101000001010100010100011
10101010101011011010001110111111110110101010101100110110110010101110011010111011
10101010000000000000000010000000000000101000100000100000000010001000001000101001
11111111001010101001100010111000101011111010101010101010110001001010111000100011
10000010001010000000101000001000000000000010000000100000000000001000000000100001
10101010101110111100101011001010110010101110111010101010111010101010100000011111
10000010000000000010000000001000100010101000000000100000001010001000001000101011
10101010101010011011001010101110001100111010011010000010101000111010101110101011
10100000001000100010001010101000000000001000001010001000001000000000000000000001
10110010101110001000100001000110101010100010001011101100110000101010101011111111
10001010101000101000100010001000000000000000000000000010000000101010000000100011
10111011111010111111101010001010111111001111111010111101101111101010001010110011
10001010001010001000101010101010000000000000000010100000100010000010001000000001
10001010101110101001101010110110110110111010100010101111101010101000101110111011
10000000000010000000000000001000100000001010100000000000000010101000100000000011
10100000101110100011100011111010001010100110001111101010101010110010111110111111
10001000000000100010000000001010001000001000000000000010000000100010000000000011
11111111111111111111111111111111111111111111111111111111111111111111111111111111
