NO ./img/wall_n.xpm
SO ./img/wall_s.xpm
WE ./img/wall_w.xpm
EA ./img/wall_e.xpm
F 220,100,0
C 225,30,0
1111111111111111111111111
1000000000000000000000001
1010101111010110001010101
1000001000001000000000001
1011101000101011101011101
1000100000000010001000001
1010100010101011000001101
1000001010001010001010001
1011111111101010110000101
1000000000000010001010001
1010000010101010101011111
1010000000000010000000001
1010100111011110101010101
1000100000100000001000001
1010010010111100111011101
1000000000100010101000001
1011101110111001001111101
1000000010000010100000101
1010101001101010111011101
1000100010100010100010101
1011001010101010101010101
10001010100010101010W0001
1100111011100010101000101
1000000000100000000000001
1111111111111111111111111
