NO ./img/wall_n.xpm
SO ./img/wall_s.xpm
EA ./img/wall_e.xpm
WE ./img/wall_w.xpm

F 64,32,0
C 192,224,255

 11111111111111111111111
1000000000000000000000001
1000000000000000000000001
 10000000000000000000001
  100000000000000000001
   1000000000000000001
    10000000000000001
     1000000N0000001
      1000000000001
       10000001001
        100100001
         1000001
          10001
           101
            1